                                                        .
                                                        .
                                                        .
                                                        .
                                                        .
                      O                                                        .
                      |                                                        .
                      O                                                                             .
                      |                                                                             .
                      O                                                                             .
                      |   las                                                                       .
            K   I     O- loren  U                                                                   .
             9 /      |        /                                                                    .
              O       O       O^U                                                                   .
               9      |      /                                                                      .
              U^O     O     O                                                                       .
                 9    |    /                                                                        .
                  O G O S O                                                                         .
                   9| | |/                                                                          .
            Z   U   O-O-O   P   G                                                                   .
            |   |   |X|X|   |   |                                                                   .
            O-O-O-O-O-T-O-O-O-O-O                                                                   .
            |   |   |X|X|   |                                                                       .
            S   V   O-F-O   B                                                                       .
                   /| |  9        athel loren                                                                       .
                  O   O-G O                                                                         .
                 /    | ^  9                                                                        .
            O-O-O     O O-O O                                                                       .
               /      |      9                                                                      .
              O       O       O                                                                     .
             /        |        9                                                                    .
            O         O-O-O-O   O-O                                                                 .
                      | |X|X|   |X|                                                                 .
                      O-O-O-O   O-O                                                                 .
                      |                                                                             .
                      O                                                                             .
                      |                                                                             .
                      O                                                                             .
                      |                                                                             .
                      O                                                                             .
                      |                                                                             .
                    O-O-O                                                                           .
                     /| |                                                                           .
                  O-O O O---L                                                                       .
                    | |  9  |                                                                       .
                  O-O O   O L                                                                       .
                    | |   |                                                                         .
                    O O   O    palac                                                                .
                          |                                                                         .
                          O                                                                         .
                           9                                                                        .
                            O                                                                       .
                                                                                                    .
                                                                                                    .
                                                                                                    .
                                            