                                                                                                                                                                                .
                                                                                                                                                                                .
                                                                                                                                                                                .
                                                                                                                                                                                .
                                                                                                                                                                                .
          w i e l k i e   m o r z e                                                   w i e l k i e   m o r z e                                                                  .
                                                                                                                                                                                .
                                                                                                                                                                                .
                                                                                                                                                                                .
                                                                                                                                                                                .
                                                                                                                                                                                .
                                                                                                                                                                                .
             plaza                                                                                      N                                                                        .
                                                                                                         9                                                                       .
                    U                                                                     O           N   O-O                                                                    .
               9   /    wies                                                              ^          /    |                                                                      .
              G-O-O-F-O                                                                   O         N   O-O-O                                                                    .
                |  9|                                                                     ^          9   /                                                                       .
              O-O   O-O                                                                   O-N         O-O-O                                                                      .
                   /|  9                                                                   /         #                                                                           .
                  O U   O   O^O   O---O                                                   N N   N N O       O-O                                                                  .
                         9 /   9  |    9                                                  | |   | |/       /                                                                     .
                          O     O^O     O                                                 N-O---O-O-G^O K-O       baccala                                                                       .
                                         9                                                   9     9      |                                                                      .
                                          O---O^O                       O     O-S       Z-O---O---O-O-S B |                                                                      .
                                                |                        9   /             9 /   /  |  /  |                                                                      .
                                                O         O               O O-O         O R-O   O---O-O   O-O                                                                    .
                                                 9       / 9              | |           |    9 /    | |   |                                                                      .
                                                  O^O---O   O             S-O-O   S O O-O-----O-O   O-O---O-O-------O                                                            .
                                                             9           /    |   | |         |     | |  /   9     /                                                             .
                                                              O---O     O     | W O-O       O-O-O   | | /   O 9   /                                                              .
                                                                   9          | |/            |     | |/    |  9 /                                                               .
                                                                    O---O---O O-O-O           T     O-O-1 O-1   O-P                                                              .
                                                                           / / / 9            |        9       /                                                                 .
                                                                          O O O^M O----O      O         O-----O                                                                  .
                                                                          |             9     |                                                                                  .
                                                                          O              O----O                                                                                  .
                                                                           9                   9                                                                                 .
                                                                            O---O       O---O---O-O                                                                              .
                                                                                 9     /          |                                                                              .
                                                                                  O---O     O-O   |         l a s                                                        .
                                                                                              |   |                                                                 .
                                                                                              O   |                                                                              .
                                                                                      zajazd  |   |                                                                              .
                                                                                              G   |                                                                              .
                                                                                              ^9  |                                                                      .
                                                                                              O O-O                                                                      .
                                                                                               / /                                                                              .
                                                                                              O O                                                                                .
                                                                                               /                                                                                 .
                                                                                              O                                                                                  .
                                                                                l a s         |                                                                                  .
                                                                                              O                                                                                  .
                                                                                               9                                                                                 .
                                                                                                O                                                                                .
                                                                                               /                                                                                 .
                                                                                            O-O                                                                                  .
                                                                                            |                                                                                    .
                                                                                            O                                                                                    .
                                                                                             9                                                                                   .
                                                                                              O                                                        .
                                                        .
                                                        .
                                                        .
                                                        .
                                                        .
                                                                                              