                                                        .
                                                        .
                                                        .
                                                                                                                                   .
                                                  |                                                                                .
                                                  O                                                                                .
                                                  |        |                                                                       .
                                        O-O-O     O    O O O                                                                       .
                                          |      /      9| |      laboratorium                                                                          .
                                        O-O-O   O      L-O-O-O                                                                     .
        twierdza pod gora carbon          |    /|        |   |                                                                     .
                                        S O G / O        O-O-O-S                                                                   .
                                        |  9|/  |        | | |                                                                     .
                                O   O-O-O---O-S          O-O O                                                                     .
                                 9          |                                                                                      .
                            O O   O         O                                                                                      .
                            |  9 /          |                                                                                      .
                          O-O^O O           O                                                                                      .
                             9 9|           |                                                                                      .
                            S O O---O---O---O                                                                                      .
                             9 /             9                                                                                     .
                          G   O               O                                                                                    .
                           9 / 9             / 9          |                                                                        .
            O-    P   S     O   Y     L     M   O         O                                                                        .
            |     |   |    /          |          9        |                                                                        .
          O-O-O-O-O---O---F   S       O-O-O       O-O^O^O^O-O-  do kopalni                                                         .
              |   |   |    9 /        |          /                                                                                 .
              O   | O-O   V-O   S   O-O-O       O                                                                                  .
                  |    9|    9 /      |        / 9                                                                                 .
               O--O^K-O G     O     O^O       O   G                                                                                .
                 ^|   | |    / 9    |        /     9                                                                               .
               -G       O   B   O---O---O---O       O                                                                              .
                            |  / 9      |   |                                                                                      .
                              O   O     O^  #                                                                                      .
                              |   |                                                                                                .
                            O-O   O      zachodni mahakam                                                                   .
                              |9  |                                                                                                .
                              O O O-O                                                                                              .
                                   9                                                                                               .
                                    O                                                                                              .
                                                                                                                                   .
                                                                                                                                   .
                                                                                                                                   .
                                                                                                                                   .
                                                              .
                                                              .
                                                              .
                                                              .
                                                              .
      